{
	"level_name" : "level_3",
	"map_grid": [[0,0,1,0,0,0,0,0],
			 	 [0,0,1,0,0,0,0,0],
				 [0,0,1,0,0,1,1,1],
				 [0,0,1,0,0,1,0,0],
				 [0,0,1,0,0,1,0,0],
				 [0,0,0,0,0,0,0,0],
				 [0,1,1,1,0,0,0,0],
				 [0,0,0,0,0,0,0,0]
				],
	"map_items": [[0,0,0,0,0,0,0,1],
				  [0,0,0,0,0,0,0,0],
				  [0,0,0,0,0,0,0,0],
				  [2,0,0,0,0,0,0,0],
				  [0,0,0,0,0,0,0,2],
				  [0,0,0,2,0,0,0,0],
				  [0,0,0,0,0,0,0,0],
				  [0,0,0,0,0,2,0,0]
				 ],
	"lvl_obj": 4,
	"len_x":8,
	"len_y":8
}