{
	"level_name" : "level_4",
	"map_grid": [[0,1,1,0,0,0,1,0,0,0,0],
			 	 [0,0,0,0,0,0,0,0,0,0,0],
				 [1,1,1,0,0,0,1,1,1,1,0],
				 [0,0,1,0,0,0,0,0,0,1,0],
				 [0,0,0,0,0,1,0,0,0,1,0],
				 [0,0,1,0,0,1,0,0,0,1,0],
				 [0,1,1,1,0,0,0,0,0,1,0],
				 [0,1,0,1,0,0,0,0,0,1,0],
				 [0,1,1,1,0,0,0,0,0,1,0],
				 [0,0,1,0,0,0,0,0,0,1,0],
				 [0,0,0,0,0,1,1,0,0,1,0],
				 [0,0,0,0,0,1,1,1,1,1,0]
				],
	"map_items":[[0,0,0,2,0,0,0,0,0,0,0],
			 	 [0,0,0,0,0,0,0,0,0,0,0],
				 [0,0,0,0,0,0,0,0,0,0,0],
				 [0,0,0,0,0,0,0,0,0,0,0],
				 [0,0,0,0,0,0,0,0,0,0,0],
				 [0,0,0,0,0,0,0,0,0,0,0],
				 [0,0,0,0,0,0,0,0,0,0,0],
				 [0,0,0,0,0,0,0,0,0,0,0],
				 [0,0,0,0,0,0,0,0,0,0,0],
				 [0,0,0,0,0,0,0,0,2,0,0],
				 [2,0,0,0,0,0,0,2,0,0,0],
				 [0,0,0,0,0,0,0,0,0,0,1]
				],
	"lvl_obj": 4,
	"len_x":11,
	"len_y":12
}